市委委员	职位与职称
市委候补委员	职位与职称
市人大常委	职位与职称
省政协委员	职位与职称
市政协委员	职位与职称
全国人大代表	职位与职称
省人大代表	职位与职称
全国党代表	职位与职称
省党代表	职位与职称
班子成员	职位与职称
正局正职	职位与职称
正局实职	职位与职称
副局实职	职位与职称
正处实职（市管）	职位与职称
街道党工委书记	职位与职称
街道办主任	职位与职称
一级巡视员	职位与职称
二级巡视员	职位与职称
一级调研员（副局级）	职位与职称
一级调研员	职位与职称
适应期	职位属性
破格提拔	职位属性
公选干部	职位属性
专项工作经历	经历
挂职经历	经历
中央部委经历	经历
省级单位经历	经历
央企经历	经历
国企经历	经历
民企经历	经历
外企经历	经历
事业单位经历	经历
高校科研院所经历	经历
境外工作经历	经历
应急管理经历	经历
金融从业经历	经历
产业部门经历	经历
市直部门一把手经历	经历
各区党政正职经历	经历
镇街工作经历	经历
镇街党政正职经历	经历
本市领导	机构类别
本市人大直属	机构类别
本市政府直属	机构类别
本市委直属	机构类别
本市政协直属	机构类别
本市法院与检察院	机构类别
本市事业单位与国企	机构类别
本市区政府部门	机构类别
市外政府部门	机构类别
市外事业单位	机构类别
市外企业单位	机构类别
